-4
12
-5
4
00000000000000000
01000000000100000
00000000000000000
00000000011111110
00000000011111110
00000000011111110
00000000011111110
00000000011111110
00000000011111110
10000000011111110
