-16
20
-15
14
0000000000000000000000000000000000000
1111111111111111111111111111111111110
1000000000000000000000000000000000010
1000000000000000000000000000000000010
1000000000000000000000000000000000010
1000000000000000000000000000000000010
1000000000000000000000000000000000010
1000000000000000000000000000000000010
1000000000000000000000000000000000010
1000000000000000000000000000000000010
1000000000000000000000000000000000010
1000000000000100000000010000000000010
1000000000000000000000000000000000010
1000000000000000000001111111000000010
1000000000000000000001111111000000010
1000000000000000000001111111000000010
1000000000000000000001111111000000010
1000000000000000000001111111000000010
1000000000000000000001111111000000010
1000000000001000000001111111000000010
1000000000000000000000000000000000010
1000000000000000000000000000000000010
1000000000000000000000000000000000010
1000000000000000000000000000000000010
1000000000000000000000000000000000010
1000000000000000000000000000000000010
1000000000000000000000000000000000010
1000000000000000000000000000000000010
1000000000000000000000000000000000010
1111111111111111111111111111111111110
